40 size
16 width
8 height
0000000000000000
0000000111100000
0000000000000000
0000000000000000
0000000000011111
0000000000000000
0000000000000000
1111111111111111