20 = size
40 = width
27 = height
1111111111111111111111111111111111111111
1110000000000000000000000000000000000001
1100000000000000000000000000000000000001
1100000000000000000000000000000000000001
1100000000000000000000000000000000000001
1100000011111000000000000000000000000001
1100000000000000000000000000000000000001
1100000000000000000000000000000000000001
1000000000000000000000000000000000000001
1000000000000000000000000000000001100001
1000000000000000000000000000000001100001
1000000000111111000000001111111111100001
1000000000111111000000001111111111100001
1000000000000000000000000000000000000001
1000000000000000000000000000000000000001
1000000001111111100000000000000000000001
1000000000000000000000000000000000000001
1100000000000000000000000000000000000011
1000000000000000000000000000000000000001
1000000000000000000000000000000001000001
1111111111111111111111111111111111000001
0000000000000000000000000000000000000000
0000000000000000000000000000000000000000
0000000000000000000000000000000000000000
0000000000000000000000000000000000000000
0000000000000000000000000000000000000000
1111111111111111111111111111111111111111
4 = amount of objects
box 8   3   40  25
box 27  10  30  30
box 4   19  25  25
box 9   7   60  60