20 size
40 width
22 height
1111111111111111111111111111111111111111
1110000000000000000000000000000000000001
1100000000000000000000000000000000000001
1100000000000000000000000000000000000001
1100000000000000000000000000000000000001
1100000000000000000000000000000000000001
1100000000000000000000000000000000000001
1100000000000000000000000000000000000001
1000000000000000000000000000000000000001
1000000000000000000000000000000001100001
1000000000000000000000000000000001100001
1000000000111111000000001111111111100001
1000000000111111000000001111111111100001
1000000000000000000000000000000000000001
1000000000000000000000000000000000000001
1000000001111111100000000000000000000001
1000000000000000000000000000000000000001
1100000000000000000000000000000000000011
1000000000000000000000000000000000000001
1000000000100001000000000001000000000001
1111111111111111111111111111111111111111
1111111111111111111111111111111111111111