20 size
40 width
22 height
0000000000000000000000000000000000000000
1000000000000000000000000000000000000000
1000001000000000000000000000000000000000
1000001000000000000000000000111111111000
1000001000000000000000000000000000000000
1000001000000000000000000000000000000000
1000001000000000000000000000000000000000
1000001000000000000000000000000000000000
1000001000000000000000000000000000000000
1000001000000000000000000111100000000000
1000001000000000000000000000000000000000
1000001000011111000000000000000000000000
1000000000000000000000000000000000000000
1000000000000000000000000000000000000000
1000000000000000000000000011111100000000
1111111111111111111111111111111111111111
1111000000000000000000000000000000000000
1111000000000000000000000000000000000000
1111000000000000000000000000000000000000
1111000000000000000000000000000000000000
1111000000000000000000000000000000000000
1111000000000000000000000000000000000000