1111111111111111111111111111111111111111
1110000000000000000000000000000000000001
1100000000000000000000000000000000000001
1100000000000000000000000000000000000001
1100000000000000000000000000000000000001
1100000000000000000000000000000000000001
1100000000000000000000000000000000000001
1100000000000000000000000000000000000001
1100000011111000000000000000000000000001
1100000000000000000000000000000000000001
1100000000000000000000000000000000000001
1100000000000000000000000000000000000001
1100000000000000000000000000000000000001
1100000000000000000000000000000000000001
1000000000000000000000000000000000000001
1000000000000000000000000000000001100001
1000000000000000000000000000000001100001
1000000000000000000000000000000001100001
1000000000111111000000001111111111100001
1000000000111111000000001111111111100001
1000000000111111000000001111111111100001
1000000000111111000000001111111111100001
1000000000000000000000000000000000000001
1000000000000000000000000000000000000001
1000000001111111100000000000000000000001
1000000001111111100000000000000000000001
1000000000000000000000000000000000000001
1100000000000000000000000000000000000011
1100000000000000000000000000000000000011
1000000000000000000000000000000000000001
1000000000000000000000000000000001000001
1000000000000000000000000000000001000001
1111111111111111111111111111111111000001
1111111111111111111111111111111111000001
1000000000000000000000000000000000000000
1000000000000000000000000000000000000000
1000000000000000000000000000000000000000
1000000000000000000000000000000000000000
1000000000000000000000000000000000000000
1111111111111111111111111111111111111111
1111111111111111111111111111111111111111

18 = size
5 = amount of objects
duc 17  13  52  52
box 8   3   38  27
box 27  10  33  33
box 4   19  22  22
box 9   7   62  62