20 size
40 width
22 height
0111111111111111111111111111111111111111
0000000000000000000000000000000000000001
1000000000000000000000000000000000000001
1000000000000000000000000000000000000001
1000000000000000000000000000000000000001
1000000000000000000000000000000000000001
1000000000000000000000000000000000000001
1000000000000000000000000000000000001001
1000000000000000000000000000000000001001
1000000000000000000000000000000001100001
1000000000000000000000000000000001100001
1000000000111111111111111111111111100001
1000000000111111111111111111111111100001
1111000000000000000000000000000000000001
1000000000000000000000000000000000000001
1000000001111100000000000000000000000001
1000000000000000000000000000000000000001
1111000000000000000000000000000000000001
1000000000000000001100000000000000000001
1000000000000000001100000000000000000001
1111111111111111111111111111111111111111
1111111111111111111111111111111111111111